Англійська (США): en_US
Англійська (Великобританія): en_GB
Українська: uk
Російська: ru_RU
Німецька: de_DE
Французька (Франція): fr_FR
Іспанська (Іспанія): es_ES
Італійська: it_IT
Голландська: nl_NL
Польська: pl_PL
Португальська (Бразилія): pt_BR
Португальська (Португалія): pt_PT
Шведська: sv_SE
Данська: da_DK
Норвезька (Bokmål): nb_NO
Фінська: fi
Японська: ja
Китайська (Спрощена): zh_CN
Китайська (Традиційна): zh_TW
Корейська: ko_KR
Арабська: ar
Турецька: tr_TR
Перська: fa_IR
Івритська: he_IL
Грецька: el
Хінді: hi_IN
Тайська: th
В'єтнамська: vi
Індонезійська: id_ID
Чеська: cs_CZ
Словацька: sk_SK
Угорська: hu_HU
Румунська: ro_RO
Болгарська: bg_BG
Хорватська: hr
Сербська: sr_RS
Литовська: lt_LT
Латвійська: lv
Естонська: et
Словенська: sl_SI